As fobias resultam da aversão ou medo psiconeurótico a objetos ou situações particulares. O número de fobias possíveis é quase infinito. Os dicionários médicos assinalam muitas centenas. Os nomes das fobias são derivados da conjunção do nome grego que indica a coisa temida ao sufixo fobia.


== A ==


== B ==

 Bacilofobia ou Bacteriofobia  — medo de bactérias (Microbiofobia);
 Balistofobia  — medo de mísseis;
 Basofobia ou basifobia  — medo de andar ou cair (inabilidade de ficar em pé);
 Batofobia  — medo de profundidade;
 Batofobia  — medo de alturas ou ficar fechado em edifícios altos;
 Batracofobia  — medo de anfíbios (como sapos, salamandras, rãs etc.);
 Beatlefobia  — medo de besouros
 Belonofobia  — medo de objetos pontiagudos, afiados;
 Bifobia  — aversão ou preconceito a bissexuais;
 Blennofobia — medo de muco ou coisas viscosas;
 Brontofobia  — medo de trovões e relâmpagos;
 Biofobia  — medo da vida.
Botanofobia — medo de plantas


== C ==


== D ==
 Darwinofobia  — aversão ou repulsa ao darwinismo e a Charles Darwin.
 Decidofobia  — aversão de tomar decisões;
 Deipnofobia  — medo de jantar e conversas do jantar;
 Demonofobia  — medo de demônios;
 Demofobia ou enoclofobia  — medo de multidão (agorafobia);
 Dendrofobia  — medo de árvores;
 Dermatosiofobia, dermatofobia ou dermatopatofobia  — medo de doenças de pele;
 Dextrofobia  — medo de objetos do lado direito do corpo;
 Diabetofobia  — medo de diabetes;
 Dinofobia  — medo de vertigens ou redemoinho;
 Diplofobia  — medo de visão dupla;
 Dipsofobia  — medo de beber (bebidas alcoólicas);
 Disabiliofobia  — medo de se vestir na frente de alguém;
 Dismorfofobia  — medo de deformidade;
 Distiquifobia  — medo de acidentes;
 Domatofobia ou oiquofobia  — Medo de casas ou estar em casa;
 Dorafobia  — medo de pele de animais;
 Dromofobia  — medo de cruzar ruas.


== E ==


== F ==
 Fagofobia  — medo de engolir ou de comer;
 Falacrofobia  — medo de tornar-se careca;
 Farmacofobia  — medo de tomar remédios;
 Febrifobia, fibrifobia ou fibriofobia  — medo de febre;
 Fengofobia  — medo da luz do dia ou nascer do sol;
 Felinofobia  — medo de gatos (ailurofobia, elurofobia, galeofobia, gatofobia);
 Filemafobia ou filematofobia  — medo de beijar;
 Filofobia  — medo de apaixonar-se;
 Filosofobia  — medo de filosofia;
 Fobia social  — medo de estar sendo avaliado negativamente (socialmente);
 Fobofobia  — medo de fobias;
 Fonofobia  — medo de barulhos ou vozes ou da própria voz de telefone;
 Fotoaugliafobia  — medo de luzes muito brilhantes;
 Fotofobia  — medo de luz;
 Fronemofobia  — medo de pensar;
 Ftisiofobia  — medo de tuberculose;
 Flatusfobia  — medo de liberar flatos


== G ==
 Galeofobia ou gatofobia — medo de gatos, mesmo que Ailurofobia;
 Gamofobia — medo de casar;
 Gatesfobia — medo de ficar rico;
 Gefirofobia, gefidrofobia ou gefisrofobia — medo de cruzar pontes;
 Geliofobia — medo de rir;
 Gelotofobia — medo de ser motivo de piada;
 Geniofobia — medo de manter a cabeça erguida;
 Gerascofobia — medo de envelhecer;
 Gerontofobia — medo de pessoas idosas;
 Geumafobia ou geumofobia — medo de sabores;
 Ghostfobia — Medo de fantasmas;
 Gimnofobia — medo de nudez;
 Ginofobia, ginefobia ou ginecofobia — medo de mulheres;
 Glossofobia — medo de falar ou tentar falar em público;
 Gnosiofobia — medo do conhecimento.
 Gordofobia — aversão à pessoas gordas.


== H ==


== I ==

 Iatrofobia  — medo de ir ao médico;
 Ictiofobia  — medo de peixe;
 Ideofobia  — medo de ideias;
 Ilingofobia  — medo de vertigem ou sentir vertigem quando olha para baixo;
 Iofobia  — medo de veneno;
 Insectofobia  — medo de insectos;
 Isolofobia  — medo da solidão, de estar sozinho, o medo de ficar isolado (Autofobia, Monofobia);
 Isopterofobia  — medo de cupins.


== L ==


== M ==


== N ==


== O ==


== S ==


== T ==


== Referências ==


== Bibliografia ==
Igor Rafailov (2003). Dicionario Igor de Fobias. [S.l.]: Forum de Fobias. ISBN 978-85-903801-1-5 
Tomo. Fobias Quiere Acabar Con Ellas: Descubra Como Vencer Su Miedo. [S.l.]: Grupo Tomo. ISBN 978-970-666-880-6 
Adriano Purgato (2006). Fobie. Le nuove ossessioni del XXI secolo. [S.l.]: Castelvecchi. p. 121. ISBN 978-88-7615-134-7